"Query","Match","HMDB","PubChem","KEGG","SMILES","Comment"
"HMDB0172136","NA","NA","NA","NA","NA","0"
"HMDB0165770","NA","NA","NA","NA","NA","0"
"HMDB0165771","NA","NA","NA","NA","NA","0"
"HMDB0165773","NA","NA","NA","NA","NA","0"
"HMDB0172134","NA","NA","NA","NA","NA","0"
"HMDB0172135","NA","NA","NA","NA","NA","0"
"HMDB0240308","NA","NA","NA","NA","NA","0"
"HMDB0165772","NA","NA","NA","NA","NA","0"
"HMDB0029737","1H-Indole-3-carboxaldehyde","HMDB0029737","10256","C08493","C1=CC=C2C(=C1)C(=CN2)C=O","1"
"HMDB0004186","3-Methyldioxyindole","HMDB0004186","151066","C05834","CC1(C2=CC=CC=C2NC1=O)O","1"
"HMDB0001424","4-(3-Pyridyl)-3-butenoic acid","HMDB0001424","5478892",NA,"C1=CC(=CN=C1)/C=C/CC(=O)O","1"
"HMDB0062406","NA","NA","NA","NA","NA","0"
"HMDB0029300","p-Anisidine","HMDB0029300","7732","C19326","COC1=CC=C(C=C1)N","1"
"HMDB0167379","NA","NA","NA","NA","NA","0"
"HMDB0032578","4-Hydroxybenzylamine","HMDB0032578","97472",NA,"C1=CC(=CC=C1CN)O","1"
"HMDB0040360","NA","NA","NA","NA","NA","0"
"HMDB0036058","NA","NA","NA","NA","NA","0"
"HMDB0167378","NA","NA","NA","NA","NA","0"
"HMDB0032492","2-Propionylpyrrole","HMDB0032492","61260",NA,"CCC(=O)C1=CC=CN1","1"
"HMDB0240327","NA","NA","NA","NA","NA","0"
"HMDB0159478","NA","NA","NA","NA","NA","0"
"HMDB0159477","NA","NA","NA","NA","NA","0"
"HMDB0158747","NA","NA","NA","NA","NA","0"
"HMDB0158748","NA","NA","NA","NA","NA","0"
"HMDB0158745","NA","NA","NA","NA","NA","0"
"HMDB0158746","NA","NA","NA","NA","NA","0"
"HMDB0159480","NA","NA","NA","NA","NA","0"
"HMDB0159479","NA","NA","NA","NA","NA","0"
"HMDB0161124","NA","NA","NA","NA","NA","0"
"HMDB0161123","NA","NA","NA","NA","NA","0"
"HMDB0161125","NA","NA","NA","NA","NA","0"
"HMDB0155922","NA","NA","NA","NA","NA","0"
"HMDB0061930","NA","NA","NA","NA","NA","0"
"HMDB0033837","Dimethyl succinate","HMDB0033837","7820",NA,"COC(=O)CCC(=O)OC","1"
"HMDB0006900","(S)-2-Aceto-2-hydroxybutanoic acid","HMDB0006900","440875","C06006","CC[C@](C(=O)C)(C(=O)O)O","1"
"HMDB0002173","Solerol","HMDB0002173","21252275",NA,"C1CC(=O)OCC(C1O)O","1"
"HMDB0002074","2,2-Dimethylsuccinic acid","HMDB0002074","11701",NA,"CC(C)(CC(=O)O)C(=O)O","1"
"HMDB0000858","Monomethyl glutaric acid","HMDB0000858","73917","C02930","COC(=O)CCCC(=O)O","1"
"HMDB0000752","Methylglutaric acid","HMDB0000752","12284",NA,"CC(CC(=O)O)CC(=O)O","1"
"HMDB0000422","2-Methylglutaric acid","HMDB0000422","12046",NA,"CC(CCC(=O)O)C(=O)O","1"
"HMDB0000448","Adipic acid","HMDB0000448","196","C06104","C(CCC(=O)O)CC(=O)O","1"
"HMDB0062489","NA","NA","NA","NA","NA","0"
"HMDB0010207","L-Rhamnulose","HMDB0010207","439330","C00861","C[C@@H]([C@H]([C@@H](C(=O)CO)O)O)O","1"
"HMDB0033821","2-O-Methyl-D-xylose","HMDB0033821","560157",NA,"COC1C(O)OC(CO)C1O","1"
"HMDB0062477","NA","NA","NA","NA","NA","0"
"HMDB0062498","NA","NA","NA","NA","NA","0"
"HMDB0062499","NA","NA","NA","NA","NA","0"
"HMDB0060267","L-Fuculose","HMDB0060267","6857362","C01721","[H][C@@](C)(O)[C@@]([H])(O)[C@@]([H])(O)C(=O)CO","1"
"HMDB0005876","3-Deoxyfructose","HMDB0005876","3080627",NA,"C([C@@H]([C@@H](CO)O)O)C(=O)CO","1"
"HMDB0012327","2-Deoxygalactopyranose","HMDB0012327","439804","C02781","C1[C@H]([C@H]([C@H](OC1O)CO)O)O","1"
"HMDB0002712","1,5-Anhydrosorbitol","HMDB0002712","64960","C07326","C1[C@@H]([C@H]([C@@H]([C@H](O1)CO)O)O)O","1"
"HMDB0059625","NA","NA","NA","NA","NA","0"
"HMDB0029196","D-Fucose","HMDB0029196","444200","C01018","C[C@@H]1[C@@H]([C@@H]([C@H]([C@H](O1)O)O)O)O","1"
"HMDB0003081","Beta-D-Fucose","HMDB0003081","439650","C02095","C[C@@H]1[C@@H]([C@@H]([C@H]([C@@H](O1)O)O)O)O","1"
"HMDB0000174","L-Fucose","HMDB0000174","25310","C01019","C[C@H]1[C@H]([C@H]([C@@H](C(O1)O)O)O)O","1"
"HMDB0059624","NA","NA","NA","NA","NA","0"
"HMDB0000849","Rhamnose","HMDB0000849","25310","C00507","C[C@H]1[C@@H]([C@H]([C@H](C(O1)O)O)O)O","1"
"HMDB0124735","NA","NA","NA","NA","NA","0"
"HMDB0240304","NA","NA","NA","NA","NA","0"
"HMDB0003584","Taurocyamine","HMDB0003584","68340","C01959","C(CS(=O)(=O)O)N=C(N)N","1"
"HMDB0040367","NA","NA","NA","NA","NA","0"
"HMDB0037521","NA","NA","NA","NA","NA","0"
"HMDB0014883","Modafinil","HMDB0014883","4236",NA,"C1=CC=C(C=C1)C(C2=CC=CC=C2)S(=O)CC(=O)N","1"
"HMDB0160041","NA","NA","NA","NA","NA","0"
"HMDB0163698","NA","NA","NA","NA","NA","0"
"HMDB0165052","NA","NA","NA","NA","NA","0"
"HMDB0165051","NA","NA","NA","NA","NA","0"
"HMDB0165056","NA","NA","NA","NA","NA","0"
"HMDB0165053","NA","NA","NA","NA","NA","0"
"HMDB0165054","NA","NA","NA","NA","NA","0"
"HMDB0165057","NA","NA","NA","NA","NA","0"
"HMDB0165060","NA","NA","NA","NA","NA","0"
"HMDB0165059","NA","NA","NA","NA","NA","0"
"HMDB0171223","NA","NA","NA","NA","NA","0"
"HMDB0163699","NA","NA","NA","NA","NA","0"
"HMDB0163695","NA","NA","NA","NA","NA","0"
"HMDB0160042","NA","NA","NA","NA","NA","0"
"HMDB0160039","NA","NA","NA","NA","NA","0"
"HMDB0160038","NA","NA","NA","NA","NA","0"
"HMDB0158762","NA","NA","NA","NA","NA","0"
"HMDB0158761","NA","NA","NA","NA","NA","0"
"HMDB0156882","NA","NA","NA","NA","NA","0"
"HMDB0156881","NA","NA","NA","NA","NA","0"
"HMDB0160699","NA","NA","NA","NA","NA","0"
"HMDB0160700","NA","NA","NA","NA","NA","0"
"HMDB0163691","NA","NA","NA","NA","NA","0"
"HMDB0163694","NA","NA","NA","NA","NA","0"
"HMDB0163687","NA","NA","NA","NA","NA","0"
"HMDB0163686","NA","NA","NA","NA","NA","0"
"HMDB0163690","NA","NA","NA","NA","NA","0"
"HMDB0161121","NA","NA","NA","NA","NA","0"
"HMDB0161119","NA","NA","NA","NA","NA","0"
"HMDB0161120","NA","NA","NA","NA","NA","0"
"HMDB0161118","NA","NA","NA","NA","NA","0"
"HMDB0167299","NA","NA","NA","NA","NA","0"
"HMDB0012267","N-Succinyl-L,L-2,6-diaminopimelate","HMDB0012267","25202447","C04421","C(C[C@@H](C(=O)O)NC(=O)CCC(=O)O)CC(C(=O)O)N","1"
"HMDB0032992","Furaneol 4-glucoside","HMDB0032992","14259114",NA,"CC1OC(C)=C(OC2OC(CO)C(O)C(O)C2O)C1=O","1"
"HMDB0179393","NA","NA","NA","NA","NA","0"
"HMDB0179378","NA","NA","NA","NA","NA","0"
"HMDB0179374","NA","NA","NA","NA","NA","0"
"HMDB0179371","NA","NA","NA","NA","NA","0"
"HMDB0179368","NA","NA","NA","NA","NA","0"
"HMDB0179370","NA","NA","NA","NA","NA","0"
"HMDB0179366","NA","NA","NA","NA","NA","0"
"HMDB0031304","Osmundalin","HMDB0031304","5249536",NA,"CC1C(C=CC(=O)O1)OC2C(C(C(C(O2)CO)O)O)O","1"
"HMDB0179364","NA","NA","NA","NA","NA","0"
"HMDB0163718","NA","NA","NA","NA","NA","0"
"HMDB0169674","NA","NA","NA","NA","NA","0"
"HMDB0169701","NA","NA","NA","NA","NA","0"
"HMDB0163365","NA","NA","NA","NA","NA","0"
"HMDB0163366","NA","NA","NA","NA","NA","0"
"HMDB0163368","NA","NA","NA","NA","NA","0"
"HMDB0163372","NA","NA","NA","NA","NA","0"
"HMDB0165598","NA","NA","NA","NA","NA","0"
"HMDB0165599","NA","NA","NA","NA","NA","0"
"HMDB0165602","NA","NA","NA","NA","NA","0"
"HMDB0165606","NA","NA","NA","NA","NA","0"
"HMDB0013854","N4-Acetylsulfamethoxazole","HMDB0013854","80641","C13061","CC1=CC(=CC(=C1NC(=O)C)C)O","1"
"HMDB0167783","NA","NA","NA","NA","NA","0"
"HMDB0167780","NA","NA","NA","NA","NA","0"
"HMDB0034058","Quinacridone","HMDB0034058","13976",NA,"C1=CC=C2C(=C1)C(=O)C3=CC4=C(C=C3N2)C(=O)C5=CC=CC=C5N4","1"
"HMDB0178297","NA","NA","NA","NA","NA","0"
"HMDB0178295","NA","NA","NA","NA","NA","0"
"HMDB0128029","NA","NA","NA","NA","NA","0"
"HMDB0171101","NA","NA","NA","NA","NA","0"
"HMDB0151544","NA","NA","NA","NA","NA","0"
"HMDB0151545","NA","NA","NA","NA","NA","0"
"HMDB0131260","NA","NA","NA","NA","NA","0"
"HMDB0240531","NA","NA","NA","NA","NA","0"
"HMDB0240529","NA","NA","NA","NA","NA","0"
"HMDB0131259","NA","NA","NA","NA","NA","0"
"HMDB0131258","NA","NA","NA","NA","NA","0"
"HMDB0128028","NA","NA","NA","NA","NA","0"
"HMDB0040621","NA","NA","NA","NA","NA","0"
"HMDB0180003","NA","NA","NA","NA","NA","0"
"HMDB0126429","NA","NA","NA","NA","NA","0"
"HMDB0124977","NA","NA","NA","NA","NA","0"
"HMDB0124976","NA","NA","NA","NA","NA","0"
"HMDB0126430","NA","NA","NA","NA","NA","0"
"HMDB0183406","NA","NA","NA","NA","NA","0"
"HMDB0167831","NA","NA","NA","NA","NA","0"
"HMDB0167833","NA","NA","NA","NA","NA","0"
"HMDB0140804","NA","NA","NA","NA","NA","0"
"HMDB0128031","NA","NA","NA","NA","NA","0"
"HMDB0062575","NA","NA","NA","NA","NA","0"
"HMDB0001235","5-Aminoimidazole ribonucleotide","HMDB0001235","161500","C03373","C1=C(N(C=N1)[C@H]2[C@@H]([C@@H]([C@H](O2)COP(=O)(O)O)O)O)N","1"
